0011111111111111111111111111111111111111111111111111111111111111111111
0010000000000000000000000000000000000000000000000000000000000000000001
0010000000000000000000000000000000000000000000000000000000000000000001
0010000000000000000000000000000000000000000001111000000000000000000001
0010000000000000000000000000011110000000000001001000000000000000000001
0010000000000000000000000000010000000000000001001000000000000000000001
0010000000000000000000000011110011111111100001001111100000000000000001
0010000000000000000000000010000000000000100001000000100000000000000001
0010000000000011110001111110000000000000100001000000100001111000000001
0010000000000000010001000000000000000000100001000000100000001000000001
0010000111000000011111000000000000000000100001000000100000001000000001
0010000001111000000000000000000000000000100001000000100000001000011111
0010000000000000000000000000000000000000100001000000111111111000010000
0011111000000000000000000000000000000000100001000000000000000000010000
0010000000001000000000000000000000000000100001000000000000000000010000
0010000000001000111111000011111110000000100001000000000000000111110000
0010000011111000000000000000000010000000100001000000000000000100000000
0010000000000000000000000000000010000000100001000000000111000100000000
0010000000000000000000000000000011110000100001000000000001000100000011
0010000000000000000000000000000000000000100001111110000001000100000000
0010000000000000000000000000000000000000100000000010000001111100000000
0000000011100011110000011111111111111111100000000010000000000000111110
0000000010100010000000010000000000000000000000000010000000000000000000
0000000010100010000000010000000000000000000000000010010000000000000000
1111111110100011111111110000000000000000000000000010000001111110000000
