100000000000000000000000000001111110000100000000000000000000000000001111110000
000000000000111111111111100000000000000000000000000111111111111100000000000000
111111000000000000000000000000011110000111111000000000000000000000000011110000
000000000000000000000000111110000000000000000000000000000000000111110000000000
111111111000000000000000000000000000000111111111000000000000000000000000000000
000000000111100000000001111000000000000000000000111100000000001111000000000000
000000000000000001111000000000000011111000000000000000001111000000000000011111
001111100000000000000000000000000000011001111100000000000000000000000000000011
000000000000000011111100000000011101111000000000000000011111100000000011101111
100000111111000000000000111110000000000100000111111000000000000111110000000000
000000000000000000000000000000000000000000000000000000000000000000000000000000
111111100001110011110000111111001111110111111100001110011110000111111001111110
100000000000000000000000000001111110000100000000000000000000000000001111110000
000000000000111111111111100000000000000000000000000111111111111100000000000000
111111000000000000000000000000011110000111111000000000000000000000000011110000
000000000000000000000000111110000000000000000000000000000000000111110000000000
111111111000000000000000000000000000000111111111000000000000000000000000000000
000000000111100010000001111000000000000000000000111100000000001111000000000000
000000000000000000011110000000000011111000000000000000000011110000000000011111
001111100000000000000000000000000000011001111100000000000000000000000000000011
100000000000000001111100000000011101111100000000000000001111100000000011101111
000000111111000000000000000110000000000000000111111000000000000000110000000000
000000000000000000000000000000000000000000000000000000000000000000000000000000
111111100001110011110000111111001111110111111100001110011110000111111001111110
000000000000000000000000000000000000000000000000000000000000000000000000000000