00100000000000000000000000000000000000001
00100001110000000000000000000000000000001
00100000010000000000000000000000000000001
00100000011110000000000000000000000000001
00100000000000000000000000000000000000001
00111110000000000000000000000000000000001
00100000000010000000000000000000000000001
00100000000010001111110000111111100000001
00100000111110000000000000000000100000001
00100000000000000000000000000000100000001
00100000000000000000000000000000011100001
00100000000000000000000000000000000000001
00100000000000000000000000000000000000001
00000000111000111100000111111111111111111
00000000101000100000000100000000000000000
00000000101000100000000100000000000000000
11111111101111111111111100000000000000000
