001111111111111111111111111111111111111111000000000000000
001000000000000000000000000000000000000000000000000000000
001000000000000000000000000000000000000000000000000000000
001000000000000000000000000000000000000000000000000000000
001000000000000000000000000001111000000000000000000000000
001000000000000000000000000001000000000000000000000000000
001000000000000000000000001111001111111110000000000000000
001000000000000000000000001000000000000000000000000000000
001000000000001111000111111000000000000000000000000000000
001000000000000001000100000000000000000000000000000000000
001000011100000001111100000000000000000000000000000000000
001000000111100000000000000000000000000000000000000000000
001000000000000000000000000000000000000000000000000000000
001111100000000000000000000000000000000000000000000000000
001000000000100000000000000000000000000011111111100000000
001000000000100011111100001111111000000010000000000000000
001000001111100000000000000000001000000010000000000000000
001000000000000000000000000000001000000010000000000000000
001000000000000000000000000000000111000010000000000000000
001000000000000000000000000000000000000010000000000000000
001000000000000000000000000000000000000010000000000000000
000000001110001111000001111111111111111110000000000000000
000000001010001000000001000000000000000000000000000000000
000000001010001000000001000000000000000000000000000000000
111111111011111111111111000000000000000000000000000000000
